1111111111111
1PE10000000C1
1000011111V01
1P0V11EC00001
1111111111111