1111111111111111111111111111111111
1E0000000000000C00000C000000000001
101001V1001V0V0V1010010000000101V1
1010010010101010001001000000010101
1P0000000C00C000000000000V000000C1
1111111111111111111111111111111111